R 1920 1080
SO ./textures/greystone.xpm
NO ./textures/redbrick.xpm
EA ./textures/eagle.xpm
WE ./textures/wood.xpm
S ./textures/barrel.xpm
C 255,200,160
F 122,122,122

11111111
12222221
12222221
1E222221
11111111
