R 1920 1080
NO ./textures/redbrick.xpm
SO ./textures/bluestone.xpm
WE ./textures/colorstone.xpm
EA ./textures/greystone.xpm
1111111111111111
1010100000000001
1001000000200011
1000000000000001
1111111111111111
