1111111
1010101
1000001
1000001
1111111
