R 4294967295111 100000000
F 122,122,122
SO ./textures/greystone.xpm
NO ./textures/redbrick.xpm
EA ./textures/eagle.xpm
WE ./textures/wood.xpm

S ./textures/barrel.xpm
C 255,10,100

11111111
10000001
100N0001
10000001
11111111
