R 1920 1080
NO ./textures/redbrick.png
SO ./textures/bluestone.png
WE ./textures/colorstone.png
EA ./textures/greystone.png
1111111111111111
1010100000000001
1001000000000011
1000000000000001
1111111111111111
